#MAJORS
MAC = "countries/Macedonia.txt"
CAR = "countries/Carthage.txt"
AEG = "countries/Aegyptos.txt"
SUE = "countries/Suebi.txt"
CEL = "countries/Celtica.txt"
GAU = "countries/Gaul.txt"
ILY = "countries/Illyria.txt"
ITY = "countries/Italia.txt"
RMA = "countries/Roma.txt"
KSB = "countries/Kashubia.txt"
SXY = "countries/Germanic_Saxony.txt"
#PIRATES
EYL = "countries/Eyl.txt"
KLI = "countries/Klin.txt"
KTI = "countries/Kriti.txt"
YRB = "countries/Yarib.txt"
PIE = "countries/Pirates.txt"
#New Israel
NEK = "countries/Nekharot.txt"
#Albion
DUM = "countries/Dumnonii.txt"
CVI = "countries/Cornovii.txt"
TRN = "countries/Trinovantes.txt"
BGT = "countries/Brigantes.txt"
CYM = "countries/Cymru.txt"
PTC = "countries/Pictland.txt"
#Norse Nations
LAG = "countries/Lagrlond.txt"
NRD = "countries/Nordanvik.txt"
JUT = "countries/Jutland.txt"
DRK = "countries/Danmark.txt"
NLD = "countries/Norrland.txt"
VIN = "countries/Vinland.txt"
SKD = "countries/Skaneland.txt"
#Nordgermanic Nations
LBD = "countries/Lombardia.txt"
ALM = "countries/Alemannia.txt"
NMD = "countries/Numidia.txt"
BRM = "countries/Bremen.txt"
WSG = "countries/Wesergau.txt"
SEI = "countries/Semnia.txt"
#Iberian Nations
TTA = "countries/Tartessia.txt"
CVA = "countries/Carventa.txt"
OVA = "countries/Olivara.txt"
GDA = "countries/Gadiria.txt"
VDA = "countries/Verdena.txt"
BCA = "countries/Bellica.txt"
TRV = "countries/Tarvalia.txt"
ORA = "countries/Oravia.txt"
AUR = "countries/Aureliana.txt"
VDR = "countries/Valdorria.txt"
PTM = "countries/Portnumara.txt"
#Mongol Nations
ASG = "countries/Ashig.txt"
ZLT = "countries/Zilant.txt"
BAT = "countries/Barut.txt"
PNS = "countries/Pinsk.txt"
#Baltic Nations
RYT = "countries/Rytvinia.txt"
VZA = "countries/Verzulia.txt"
GDJ = "countries/Galdija.txt"
PTH = "countries/Pruthenia.txt"
#Ostgermanic Nations
VLD = "countries/Vildheim.txt"
OST = "countries/Ostholm.txt"
#Caucasian Nations
ALR = "countries/Alarion.txt"
TBZ = "countries/Tabrizia.txt"
#Zoroastrian Tribe
AKB = "countries/Ashkabadis.txt"
#IF Nations
LCO = "countries/Lecco.txt"
AVN = "countries/Avellino.txt"
BVE = "countries/Benevento.txt"
CTZ = "countries/Catanzaro.txt"
DDA = "countries/Dardana.txt"
PSC = "countries/Pescara.txt"
SZA = "countries/Serenza.txt"
SMN = "countries/Semnonia.txt"
ANC = "countries/Ancona.txt"
CTA = "countries/Capitanata.txt"
SNO = "countries/Salerno.txt"
MSM = "countries/Molisum.txt"
LGA = "countries/Liguria.txt"
CUN = "countries/Cunea.txt"
PCM = "countries/Punicum.txt"
AZM = "countries/Abbruzum.txt"
MPM = "countries/Montpilum.txt"
KTM = "countries/Kartamaal.txt"
SYL = "countries/Sylphoria.txt"
CLN = "countries/Carthilune.txt"
SVN = "countries/Soluventus.txt"
THS = "countries/Thalasora.txt"
NVM = "countries/Novemoria.txt"
ESN = "countries/Elysionia.txt"
TGA = "countries/Theogonia.txt"
#IF Formables
ETS = "countries/Etruscia.txt"
#Persian Satrapies
KHU = "countries/Khuzestan.txt"
BAB = "countries/Babylonia.txt"
ASY = "countries/Assyria.txt"
TIG = "countries/Tigristan.txt"
CSP = "countries/Caspia.txt"
CLC = "countries/Colchis.txt"
MGA = "countries/Magan.txt"
RJT = "countries/Rajastan.txt"
GJR = "countries/Gujaratistan.txt"
PAJ = "countries/Panjabistan.txt"
KSM = "countries/Kashmiristan.txt"
AMY = "countries/Amyrgia.txt"
#Macedonian Releasables
TCE = "countries/Thrace.txt"
INA = "countries/Ionia.txt"
ATD = "countries/Anatolides.txt"
ODR = "countries/Odrysia.txt"
#Greek Nations
BBC = "countries/Bambyce.txt"
CDN = "countries/Corduene.txt"
GAA = "countries/Garamaea.txt"
APL = "countries/Apolloniatis.txt"
SPH = "countries/Sophene.txt"
VAS = "countries/Vaspurakan.txt"
TWN = "countries/Tarawn.txt"
PMY = "countries/Palmyrene.txt"
TYN = "countries/Tyanitis.txt"
CAI = "countries/Caria.txt"
PPG = "countries/Paphlagonia.txt"
CPD = "countries/Cappadocia.txt"
AIA = "countries/Alethia.txt"
SLC = "countries/Selucia.txt"
EDS = "countries/Edessa.txt"
CMG = "countries/Commagene.txt"
JRD = "countries/Jordan.txt"
HEL = "countries/Heliopolis.txt"
CTH = "countries/Corinth.txt"
CPH = "countries/Cephalonia.txt"
URK = "countries/Uruk.txt"
BBY = "countries/Babylon.txt"
PTY = "countries/Tyre.txt"
PSI = "countries/Sidon.txt"
HMA = "countries/Hamat.txt"
LYD = "countries/Lydia.txt"
LSB = "countries/Lesbos.txt"
#Gallic Releasables
CNT = "countries/Carnutia.txt"
PCT = "countries/Pictonia.txt"
ARV = "countries/Arvenia.txt"
LNN = "countries/Lingonia.txt"
SNN = "countries/Senonia.txt"
#Albion Releasables
GDD = "countries/Gododdin.txt"
ELM = "countries/Elmet.txt"
RHG = "countries/Rheged.txt"
#Celtic Isles
ABN = "countries/Albion.txt"
BRN = "countries/Brennonia.txt"
SKL = "countries/Skaldasker.txt"
OKN = "countries/Orkneyjar.txt"
#Scandinavia
NDH = "countries/Nordheim.txt"
#Iberia
GAD = "countries/Gadrium.txt"
BOR = "countries/Boraliber.txt"
IBR = "countries/Iber.txt"
KEH = "countries/Keltheas.txt"
#Greek world
MGN = "countries/MagnaGraecia.txt"
KEM = "countries/Kemet.txt"
DCL = "countries/DualCeltica.txt"
LUG = "countries/Lugundia.txt"
ELY = "countries/Elysia.txt"
SPT = "countries/Sparta.txt"
ATC = "countries/Antioch.txt"
#Italia
RME = "countries/Rome.txt"
#Slavic
JUG = "countries/Jugoslavia.txt"
SEV = "countries/Severoslavia.txt"
SLV = "countries/Slavia.txt"
DKO = "countries/Drakova.txt"
#Germanic
DNV = "countries/Donova.txt"
MKM = "countries/Markland.txt"
SDT = "countries/Sudeten.txt"
GMN = "countries/Germania.txt"
#North African
MTN = "countries/Mauretania.txt"
AFR = "countries/Aphriqia.txt"
ZMB = "countries/Zirimbal.txt"
RAK = "countries/Rakkada.txt"
TSL = "countries/Tyrosel.txt"
#Egypt Releasables
MMP = "countries/Men-Nefer.txt"
TNU = "countries/Tehenu.txt"
KUS = "countries/Kush.txt"
IRT = "countries/Irtyu.txt"
#Crimean Releasables
TDS = "countries/Theodosis.txt"
# Slavic Releasables
POB = "countries/Polabia.txt"
POD = "countries/Podlachia.txt"
PRI = "countries/Pomoria.txt"
#East India Company :)
BIC = "countries/CelticEastIndiaCompany.txt"
# Post-Colonial formables
ISP = "countries/Isapun.txt"
PRT = "countries/Prasutaga.txt"
AVL = "countries/Avalonia.txt"
PNM = "countries/Ponnimari.txt"
ENK = "countries/Enokai.txt"
NES = "countries/Nessos.txt"
NMX = "countries/Malaika.txt"
EPR = "countries/Eparan.txt"
AMQ = "countries/Ameriq.txt"
OEA = "countries/Torea.txt"
GDH = "countries/Gimradh.txt"
ZAQ = "countries/Zaqia.txt"
TSH = "countries/Tiodash.txt"
BIR = "countries/Biru.txt"
#New world spawnables
MTG = "countries/Martiager.txt"
#New natives
PT1 = "countries/Aonikenk.txt"
PT2 = "countries/Diuihet.txt"
PT3 = "countries/Huarpe.txt"
NSE = "countries/NorthSeaEmpire.txt"
BCT = "countries/Bactria.txt"
SUM = "countries/Samnium.txt"
PGM = "countries/Pergamon.txt"
DZN = "countries/Dzintara.txt"
HVT = "countries/Helvetia.txt"
PHO = "countries/Phoenicia.txt"
SCY = "countries/Scythia.txt"
#Arabia
QAM = "countries/Qamar.txt"
BTQ = "countries/Bantariq.txt"
FLQ = "countries/Falaq.txt"
BNR = "countries/Banoor.txt"
DVA = "countries/Davia.txt"
ITH = "countries/Ionath.txt"
ZRH = "countries/Zorah.txt"
KIR = "countries/Kirel.txt"
SMR = "countries/Shamir.txt"
NEG = "countries/Negevah.txt"
KBR = "countries/Kubra.txt"
BSD = "countries/Basaad.txt"
BQL = "countries/Barqal.txt"
ABH = "countries/Albahr.txt"
SRJ = "countries/Siraj.txt"
QTF = "countries/Qitaf.txt"
SFN = "countries/Safran.txt"
MRR = "countries/Marir.txt"
TDK = "countries/Theodokos.txt"
DIL = "countries/Dilmun.txt"
MNF = "countries/Munifara.txt"
# New India!
NJC = "countries/Nijachola.txt"
HOY = "countries/Hoysala.txt"
TQB = "countries/Tranqebar.txt"
PUL = "countries/Pulicat.txt"
CDD = "countries/Cuddalore.txt"
SQD = "countries/Sukhadara.txt"
GOA = "countries/Goa.txt"
SIM = "countries/Simylla.txt"
YVN = "countries/Yavana.txt"
SMK = "countries/Sumukiun.txt"
DHW = "countries/Dharward.txt"
RAI = "countries/Raichur.txt"
NLL = "countries/Nelliuru.txt"
KNL = "countries/Kurnool.txt"
ANG = "countries/Angelcynn.txt"
#Nubia/Horn of Africa
SFD = "countries/Sofarid.txt"
ZHM = "countries/Zamharir.txt"
ADF = "countries/Adalif.txt"
MKD = "countries/Makdasha.txt"
QRS = "countries/Quraishan.txt"
HRT = "countries/Hararite.txt"
DWA = "countries/Diriwat.txt"
ABR = "countries/Abyssar.txt"
NJS = "countries/Najashi.txt"
SDN = "countries/Salahdin.txt"
MFZ = "countries/Muhafazat.txt"
BKS = "countries/Barakaysan.txt"
NBS = "countries/Nubaser.txt"
MWT = "countries/Meroweti.txt"
ATS = "countries/Anuketis.txt"
NBI = "countries/Nubia.txt"
# Central Asia
SQN = "countries/Samarkand.txt"
KHJ = "countries/Khujand.txt"
KIS = "countries/Kish.txt"
KKD = "countries/Kokand.txt"
TMZ = "countries/Termez.txt"
KLB = "countries/Kulob.txt"
UZK = "countries/Uzkend.txt"
BKH = "countries/Bukhara.txt"
QSH = "countries/Qarshi.txt"
SOG = "countries/Sogdiana.txt"
AMT = "countries/Almatau.txt"
AAE = "countries/Achaemenids.txt"
#North/South Mongols
KGS = "countries/Khagansar.txt"
TKH = "countries/Tomorkhad.txt"
QAQ = "countries/Qaraqala.txt"
SUT = "countries/Suurtei.txt"
AQM = "countries/Aqmong.txt"
DON = "countries/Donuk.txt"
ULK = "countries/Ulakhan.txt"
JRG = "countries/Jorug.txt"
KZR = "countries/Khezar.txt"
OGR = "countries/Olgor.txt"
MRT = "countries/Marut.txt"
VLN = "countries/Vellin.txt"
CZY = "countries/Chozhny.txt"
VRT = "countries/Vorut.txt"
MSK = "countries/Marusk.txt"
YTK = "countries/Yatrak.txt"